###########___###########
#_______________________#
#_______________________#
#_______________________#
#_______________________#
#_______________________#
#_______________________#
#_______________________#
#_______________________#
_________________________
_________________________
_________________________
#_______________________#
#_______________________#
#_______________________#
#_______________________#
#_______________________#
#_______________________#
#_______________________#
#_______________________#
#_______________________#
#_______________________#
#_______________________#
#_______________________#
###########___###########